guns	WEAPON	found
place	TIME	found
holster	WEAPON	found
thigh	BPART	found
hand	BPART	found
reigns	TIME	estimated
replies	TIME	estimated
lie	TIME	estimated
hat	BPART	estimated
jerks	BPART	estimated
road	LOC	found
convulses	BPART	estimated
approach	TIME	estimated
death	TIME	estimated
commands	TIME	estimated
bartender	PERSON	found
button	BPART	estimated
company	TIME	estimated
preacher	PERSON	found
neck	BPART	found
collar	BPART	estimated
paces	TIME	estimated
stairs	LOC	found
piano	TIME	estimated
pinata	ITEM	estimated
woman	PERSON	found
saddle	VEH	found
smiles	BPART	estimated
window	ITEM	estimated
picture	TIME	estimated
cheek	BPART	found
stare	BPART	estimated
fires	WEAPON	found
eyes	BPART	found
front	BPART	found
partner	TIME	estimated
town	LOC	found
blows	BPART	estimated
owner	LOC	found
hovers	BPART	estimated
glove	BPART	estimated
something	TIME	found
eye	BPART	found
dismounts	WEAPON	estimated
entrance	LOC	found
straightens	BPART	estimated
shoulder	BPART	found
nods	BPART	estimated
coffin	BPART	estimated
shot	WEAPON	found
cort	WEAPON	estimated
drinks	ITEM	found
case	TIME	estimated
tabe	ITEM	estimated
belt	BPART	estimated
worker	PERSON	estimated
places	LOC	found
movement	TIME	estimated
vest	WEAPON	found
watch	TIME	estimated
ground	BPART	found
floor	LOC	found
wales	VEH	estimated
laugh	TIME	estimated
ring	BPART	estimated
hunter	WEAPON	found
lands	LOC	estimated
rifleman	WEAPON	estimated
car	VEH	found
sherif	WEAPON	estimated
tray	ITEM	found
shifts	TIME	estimated
locket	ITEM	estimated
air	TIME	estimated
bar	LOC	found
paint	ITEM	found
bell	BPART	estimated
aim	TIME	estimated
kettle	ITEM	found
background	TIME	estimated
chamber	LOC	estimated
strikes	TIME	estimated
seat	BPART	estimated
shoulders	BPART	found
swarms	WEAPON	estimated
partons	VEH	estimated
bartenders	ITEM	estimated
end	TIME	found
round	BPART	found
times	TIME	found
what	TIME	estimated
watter	ITEM	estimated
guard	BPART	estimated
post	TIME	estimated
whistle	BPART	estimated
side	BPART	found
tests	TIME	estimated
porch	LOC	found
eachother	BPART	estimated
powder	ITEM	estimated
coat	BPART	estimated
dies	PERSON	estimated
finish	TIME	estimated
loads	TIME	estimated
position	TIME	estimated
gunfighter	WEAPON	estimated
glass	ITEM	found
shackles	BPART	estimated
gang	PERSON	found
mansion	LOC	found
sighs	BPART	estimated
spur	TIME	estimated
water	ITEM	estimated
snaps	BPART	estimated
citizens	PERSON	found
building	LOC	found
crosses	BPART	estimated
rope	BPART	estimated
stance	TIME	estimated
lights	LOC	found
music	TIME	estimated
dialog	TIME	estimated
citizen	PERSON	found
drink	ITEM	found
wire	ITEM	found
tower	LOC	found
center	LOC	found
stares	BPART	estimated
reporter	PERSON	estimated
doorway	LOC	estimated
head	BPART	found
weight	BPART	estimated
hammers	WEAPON	estimated
counters	ITEM	estimated
scar	BPART	estimated
cigar	ITEM	found
duel	WEAPON	estimated
assistant	PERSON	estimated
barm	ITEM	estimated
structure	TIME	estimated
recovers	TIME	estimated
frame	ITEM	estimated
pole	BPART	estimated
pot	ITEM	found
looks	BPART	found
crouch	BPART	estimated
comments	TIME	estimated
street	LOC	found
arms	BPART	found
rocker	BPART	estimated
man	PERSON	found
beings	TIME	estimated
pocket	BPART	estimated
return	TIME	found
indio	VEH	estimated
fence	LOC	found
box	ITEM	found
boy	PERSON	found
exits	TIME	estimated
acknowledgement	TIME	estimated
narrator	PERSON	estimated
thug	PERSON	found
bottle	ITEM	found
turn	TIME	found
claps	BPART	estimated
back	TIME	found
self	TIME	estimated
arm	BPART	found
corpses	WEAPON	estimated
leather	BPART	estimated
darkness	TIME	estimated
spot	TIME	found
tongue	BPART	found
positon	BPART	estimated
cover	TIME	estimated
wrists	BPART	found
grunts	WEAPON	estimated
laughs	TIME	estimated
hanging	BPART	found
crowds	TIME	estimated
rom	TIME	estimated
horse	VEH	found
points	TIME	estimated
graveyard	LOC	found
poncho	ITEM	estimated
clothing	ITEM	estimated
nuts	BPART	estimated
stand	BPART	found
body	BPART	found
fense	WEAPON	estimated
house	LOC	found
johnny	PERSON	estimated
spits	BPART	estimated
gun	WEAPON	found
fear	TIME	estimated
face	BPART	found
starts	TIME	estimated
moves	TIME	found
chair	ITEM	estimated
barn	LOC	found
cup	ITEM	estimated
barrel	WEAPON	found
soda	ITEM	estimated
stop	TIME	found
grabs	BPART	estimated
chain	BPART	estimated
package	TIME	estimated
figure	TIME	estimated
dirt	VEH	found
clock	TIME	estimated
reply	TIME	estimated
cracks	BPART	estimated
shoots	WEAPON	found
cloth	ITEM	estimated
tree	LOC	found
approval	TIME	estimated
corpse	BPART	estimated
rock	LOC	found
intent	TIME	estimated
crowd	TIME	estimated
barman	PERSON	estimated
grave	PERSON	found
sleeve	BPART	estimated
notices	TIME	estimated
rifle	WEAPON	found
holsters	WEAPON	found
balcony	LOC	found
thugs	PERSON	estimated
coins	ITEM	estimated
trees	LOC	found
bullet	WEAPON	found
match	TIME	estimated
riders	VEH	found
hands	BPART	found
beam	BPART	estimated
reloads	WEAPON	estimated
walking	LOC	found
screen	TIME	estimated
scene	TIME	found
fire	WEAPON	found
stumbles	PERSON	estimated
pins	BPART	estimated
playing	TIME	estimated
paper	ITEM	found
look	BPART	found
hit	TIME	estimated
counter	ITEM	estimated
hole	BPART	found
finger	BPART	found
pockets	BPART	estimated
knee	BPART	found
shane	PERSON	estimated
repeat	TIME	estimated
bullets	WEAPON	found
voice	TIME	estimated
knife	WEAPON	found
wagon	VEH	found
handle	TIME	estimated
shadows	BPART	estimated
person	PERSON	found
pen	ITEM	estimated
table	ITEM	found
alley	LOC	found
wound	BPART	found
turns	TIME	found
pain	BPART	found
right	TIME	found
mouth	BPART	found
priest	PERSON	estimated
power	TIME	estimated
teeth	BPART	found
attempts	TIME	estimated
lantern	ITEM	found
rider	PERSON	found
smirking	BPART	estimated
form	TIME	estimated
badge	WEAPON	estimated
camera	TIME	estimated
wall	LOC	found
clearing	TIME	estimated
roof	LOC	found
speaking	TIME	estimated
hammer	WEAPON	found
forehead	BPART	found
support	TIME	estimated
corner	LOC	found
stops	TIME	found
stage	TIME	found
wheel	VEH	found
legs	BPART	found
way	TIME	found
patrons	TIME	estimated
pans	ITEM	estimated
edge	BPART	found
scarf	BPART	estimated
name	TIME	estimated
war	WEAPON	found
dog	VEH	found
knees	BPART	found
bounty	PERSON	estimated
area	LOC	found
exit	TIME	estimated
foreground	LOC	estimated
fingers	BPART	found
run	TIME	found
mound	BPART	estimated
henchmen	PERSON	estimated
passenger	VEH	found
foot	BPART	found
heads	BPART	found
patron	PERSON	estimated
shirt	BPART	estimated
chambers	LOC	estimated
steps	TIME	found
cigarette	ITEM	found
barrels	WEAPON	found
photographer	PERSON	estimated
boot	BPART	estimated
bottles	ITEM	found
carriage	VEH	found
bandit	WEAPON	estimated
leg	BPART	found
men	PERSON	found
who	TIME	estimated
mirror	ITEM	estimated
cameraman	PERSON	estimated
outcome	TIME	estimated
knuckles	BPART	found
train	VEH	found
fight	TIME	estimated
bystander	PERSON	estimated
page	TIME	estimated
leaves	TIME	estimated
thumb	BPART	found
horses	VEH	found
bible	TIME	estimated
step	TIME	found
shotgun	WEAPON	found
door	LOC	found
middle	TIME	found
pistol	WEAPON	found
