guns	WEAPON	found
jerks	BPART	estimated
nuts	BPART	estimated
hand	BPART	found
reigns	TIME	estimated
replies	TIME	estimated
lie	TIME	estimated
road	LOC	found
convulses	BPART	estimated
approach	TIME	estimated
death	TIME	estimated
commands	TIME	estimated
button	BPART	estimated
bounty	PERSON	estimated
tests	TIME	estimated
neck	BPART	found
collar	BPART	estimated
paces	TIME	estimated
piano	TIME	estimated
pinata	ITEM	estimated
saddle	ITEM	found
smiles	BPART	estimated
window	ITEM	estimated
picture	TIME	estimated
starts	TIME	estimated
stare	BPART	estimated
eyes	BPART	found
partner	TIME	estimated
town	LOC	found
reloads	WEAPON	estimated
fense	WEAPON	estimated
eye	BPART	found
dismounts	WEAPON	estimated
straightens	BPART	estimated
shoulder	BPART	found
nods	BPART	estimated
lands	LOC	estimated
horse	VEH	found
tabe	ITEM	estimated
belt	BPART	estimated
pans	ITEM	estimated
corpse	BPART	estimated
car	VEH	found
watch	TIME	estimated
bell	BPART	estimated
wales	VEH	estimated
laugh	TIME	estimated
ring	BPART	estimated
coffin	BPART	estimated
rifleman	WEAPON	estimated
movement	TIME	estimated
shifts	TIME	estimated
locket	ITEM	estimated
air	TIME	estimated
bar	LOC	found
glove	BPART	estimated
aim	TIME	estimated
background	TIME	estimated
chamber	LOC	estimated
strikes	TIME	estimated
swarms	WEAPON	estimated
partons	VEH	estimated
bartenders	ITEM	estimated
what	TIME	estimated
guard	BPART	estimated
rifle	WEAPON	found
whistle	BPART	estimated
hat	BPART	estimated
crowds	TIME	estimated
porch	LOC	found
eachother	BPART	estimated
powder	ITEM	estimated
form	TIME	estimated
finish	TIME	estimated
loads	TIME	estimated
position	TIME	estimated
glass	ITEM	found
shackles	BPART	estimated
crowd	TIME	estimated
sighs	BPART	estimated
spur	TIME	estimated
weight	BPART	estimated
cover	TIME	estimated
building	LOC	found
rope	BPART	estimated
stance	TIME	estimated
repeat	TIME	estimated
music	TIME	estimated
drink	ITEM	found
stares	BPART	estimated
reporter	PERSON	estimated
doorway	LOC	estimated
water	ITEM	estimated
hammers	WEAPON	estimated
scar	BPART	estimated
pole	BPART	estimated
assistant	PERSON	estimated
barm	ITEM	estimated
structure	TIME	estimated
recovers	TIME	estimated
frame	ITEM	estimated
duel	WEAPON	estimated
face	BPART	found
crouch	BPART	estimated
comments	TIME	estimated
street	LOC	found
pins	BPART	estimated
rocker	BPART	estimated
man	PERSON	found
beings	TIME	estimated
boy	PERSON	found
exits	TIME	estimated
acknowledgement	TIME	estimated
narrator	PERSON	estimated
henchmen	PERSON	estimated
foot	BPART	found
self	TIME	estimated
arm	BPART	found
corpses	WEAPON	estimated
leather	BPART	estimated
darkness	TIME	estimated
positon	BPART	estimated
dialog	TIME	estimated
grunts	WEAPON	estimated
laughs	TIME	estimated
rom	TIME	estimated
cort	WEAPON	estimated
points	TIME	estimated
snaps	BPART	estimated
poncho	ITEM	estimated
clothing	ITEM	estimated
watter	ITEM	estimated
body	BPART	found
coat	BPART	estimated
post	TIME	estimated
house	LOC	found
spits	BPART	estimated
gun	WEAPON	found
fear	TIME	estimated
counters	ITEM	estimated
chair	ITEM	estimated
cup	ITEM	estimated
soda	ITEM	estimated
grabs	BPART	estimated
chain	BPART	estimated
package	TIME	estimated
gunfighter	WEAPON	estimated
clock	TIME	estimated
reply	TIME	estimated
cloth	ITEM	estimated
approval	TIME	estimated
intent	TIME	estimated
barman	PERSON	estimated
sleeve	BPART	estimated
notices	TIME	estimated
company	TIME	estimated
thugs	PERSON	estimated
coins	ITEM	estimated
beam	BPART	estimated
hovers	BPART	estimated
screen	TIME	estimated
fire	ITEM	found
stumbles	PERSON	estimated
sherif	WEAPON	estimated
playing	TIME	estimated
hit	TIME	estimated
counter	ITEM	estimated
head	BPART	found
pockets	BPART	estimated
shane	PERSON	estimated
indio	VEH	estimated
bottle	ITEM	found
voice	TIME	estimated
knife	WEAPON	found
wagon	VEH	found
handle	TIME	estimated
shadows	BPART	estimated
pen	ITEM	estimated
table	ITEM	found
mouth	BPART	found
priest	PERSON	estimated
power	TIME	estimated
crosses	BPART	estimated
attempts	TIME	estimated
rider	PERSON	found
smirking	BPART	estimated
badge	WEAPON	estimated
camera	TIME	estimated
clearing	TIME	estimated
speaking	TIME	estimated
match	TIME	estimated
support	TIME	estimated
stops	TIME	found
woman	PERSON	found
blows	BPART	estimated
patrons	TIME	estimated
worker	PERSON	estimated
scarf	BPART	estimated
name	TIME	estimated
seat	BPART	estimated
figure	TIME	estimated
exit	TIME	estimated
foreground	LOC	estimated
fingers	BPART	found
mound	BPART	estimated
case	TIME	estimated
dies	PERSON	estimated
claps	BPART	estimated
shirt	BPART	estimated
chambers	LOC	estimated
johnny	PERSON	estimated
cigarette	ITEM	found
pocket	BPART	estimated
photographer	PERSON	estimated
boot	BPART	estimated
bandit	WEAPON	estimated
leg	BPART	found
patron	PERSON	estimated
who	TIME	estimated
mirror	ITEM	estimated
cameraman	PERSON	estimated
outcome	TIME	estimated
train	VEH	found
fight	TIME	estimated
bystander	PERSON	estimated
page	TIME	estimated
leaves	TIME	estimated
cracks	BPART	estimated
horses	VEH	found
bible	TIME	estimated
shotgun	WEAPON	found
door	ITEM	found
pistol	WEAPON	found
