guns	WEAPON
jerks	0
nuts	ITEM
hand	BPART
reigns	0
replies	0
lie	0
road	LOC
convulses	0
approach	0
death	0
commands	0
button	0
bounty	0
tests	0
neck	BPART
collar	CLOTH
paces	0
piano	ITEM
pinata	ITEM
saddle	CLOTH
smiles	0
window	0
picture	0
starts	TIME
stare	0
eyes	BPART
partner	PERSON
town	LOC
reloads	0
fense	0
eye	BPART
dismounts	0
straightens	0
shoulder	BPART
nods	0
lands	0
horse	VEH
tabe	0
belt	CLOTH
pans	0
corpse	0
car	VEH
watch	0
bell	ITEM
wales	0
laugh	0
ring	CLOTH
coffin	0
rifleman	PERSON
movement	0
shifts	0
locket	ITEM
air	0
bar	LOC
glove	CLOTH
aim	0
background	0
chamber	LOC
strikes	0
swarms	0
partons	PERSON
bartenders	PERSON
what	0
guard	PERSON
rifle	WEAPON
whistle	0
hat	CLOTH
crowds	PERSON
porch	LOC
eachother	0
powder	0
form	0
finish	TIME
loads	0
position	0
glass	ITEM
shackles	CLOTH
crowd	PERSON
sighs	0
spur	0
weight	0
cover	0
building	LOC
rope	ITEM
stance	0
repeat	0
music	0
drink	ITEM
stares	0
reporter	PERSON
doorway	LOC
water	ITEM
hammers	WEAPON
scar	0
pole	0
assistant	PERSON
barm	0
structure	LOC
recovers	0
frame	0
duel	0
face	LOC
crouch	0
comments	0
street	LOC
pins	0
rocker	ITEM
man	PERSON
beings	PERSON
boy	PERSON
exits	0
acknowledgement	0
narrator	PERSON
henchmen	PERSON
foot	BPART
self	PERSON
arm	BPART
corpses	0
leather	0
darkness	0
positon	LOC
dialog	0
grunts	0
laughs	0
rom	0
cort	0
points	0
snaps	0
poncho	CLOTH
clothing	CLOTH
watter	0
body	BPART
coat	CLOTH
post	0
house	LOC
spits	0
gun	WEAPON
fear	0
counters	0
chair	ITEM
cup	ITEM
soda	ITEM
grabs	0
chain	0
package	ITEM
gunfighter	PERSON
clock	TIME
reply	0
cloth	CLOTH
approval	0
intent	0
barman	PERSON
sleeve	CLOTH
notices	0
company	0
thugs	PERSON
coins	ITEM
beam	0
hovers	0
screen	0
fire	0
stumbles	0
sherif	PERSON
playing	0
hit	0
counter	0
head	BPART
pockets	CLOTH
shane	PERSON
indio	0
bottle	ITEM
voice	0
knife	WEAPON
wagon	VEH
handle	ITEM
shadows	0
pen	ITEM
table	ITEM
mouth	BPART
priest	PERSON
power	0
crosses	0
attempts	0
rider	PERSON
smirking	0
badge	ITEM
camera	ITEM
clearing	LOC
speaking	0
match	0
support	0
stops	TIME
woman	PERSON
blows	0
patrons	PERSON
worker	PERSON
scarf	CLOTH
name	0
seat	ITEM
figure	0
exit	0
foreground	LOC
fingers	BPART
mound	0
case	ITEM
dies	0
claps	0
shirt	CLOTH
chambers	LOC
johnny	PERSON
cigarette	ITEM
pocket	CLOTH
photographer	PERSON
boot	CLOTH
bandit	PERSON
leg	BPART
patron	PERSON
who	PERSON
mirror	ITEM
cameraman	PERSON
outcome	0
train	VEH
fight	0
bystander	PERSON
page	ITEM
leaves	0
cracks	0
horses	VEH
bible	ITEM
shotgun	WEAPON
door	LOC
pistol	WEAPON